2 13 31
###############################
#p * *2       *  ** * *      *#
# # # # #*# # #*# # # # # #*# #
# 9  * * *** **      *    **  #
# #*# # # # #1# #b#1# # # # #*#
#     799  *     **      *  **#
# # #*# # # # # #*#*#*#*# # # #
#   * 9 7    *   7 7x7 7      #
# # # # #*# # # # # # #*# #*# #
#   ****         *1           #
# # # # # # # # # #*# # # # #*#
#  ** *   *    2              #
###############################