1 13 31
###############################
#p  w f** * 3  *   *  * * *   #
# # # #*# # #*#*# # # #*#*#*# #
#   * B b ***  *      *   * * #
# #f# # # #*# # #*#*# # # # #*#
#f  s L F  3 **  *  *   3     #
# #3# # # # # # # #*# #*# # # #
#* f* b L  *  *  x  s*  3     #
# # # # #*# # # #*#*# # # # # #
#*   3**  *  3s   *    3      #
# #*# # # # # # #*# # # # # # #
#     3 s   *   *  *   3      #
###############################