6 13 31
###############################
#p                            #
#b#f#b#f#b#f#f#s#f#L#L#L#f#f#*#
# 5          5            5  4#
#f#f#f#s#b#s#f#L#*#*#*#*#*#*#*#
# 5          5            5  3#
#*#*#*#s#*#f#*#*#f#f#L#*#f#*#*#
#     5        5   5         2#
#*#f#*#f#*#*#*#f#*#f#*#b#s#*#*#
#     5         5        5   1#
#*#*#f#b#f#f#f#s#s#b#L#*#*#*#*#
#     5     5      5         x#
###############################