7 13 31
###############################
#p**6s# 6 6 5 6 #         5**x#
# s# b#  6 6 5  #5         9**#
# b# f*         #             #
# f#6s# 655     #bfsbfs       #
# f# L#     5   #             #
# s#6*#  5      #5            #
# b# *#      5  7sff          #
# f# b# 6   5 6 #             #
# L# f#5    5   #sfbfbfbfss   #
# W# *# 6  6  5 #            5#
# f#6*#56       #             #
###############################